..#####.
###...#.
#TPB..#.
###.BT##
#T##B.##
#.#.T.##
#B.BBBT#
#...T..#
########
C9-8C