....#####.............
....#...#.............
....#B..#.............
..###..B###...........
..#..B..B.#...........
###.#.###.#.....######
#...#.###.#######..TT#
#.B..B.............TT#
#####.####.#P####..TT#
....#......###..######
....########..........
......................
C12-22C
