############..
#TT..#.....###
#TT..#.B..B..#
#TT..#B####..#
#TT....P.##..#
#TT..#.#..B.##
######.##B.B.#
..#.B..B.B.B.#
..#....#.....#
..############
C10-14C