........########..
........#.....P#..
........#.B#B.##..
........#.B..B#...
........##B.B.#...
#########.B.#.###.
#TTTT..##.B..B..#.
##TTT....B..B...#.
#TTTT..##########.
########..........
..................
C11-18C