........#####....
........#...#####
........#.#B##..#
........#.....B.#
#########.###...#
#TTTT..##.B..B###
#TTTT....B.BB.##.
#TTTT..##B..B.P#.
#########..B..##.
........#.B.B..#.
........###.##.#.
..........#....#.
..........######.
C13-17C
